32 32
22222222222222222222222222222222
22111111111111111111111111111122
21000000010000000000000000000012
21000000010000000000000000000012
21000000010000000000000000000012
21000000010000000000000000000012
21000000010000000000000000000012
21000000010000000000000000000012
21000000010000000000000000000012
21000000010000000000000000000012
21000000010000000000000000000012
21000000000000000000000000000012
21000000000000000000000000000012
21000000000000000000000000000012
21000000000000000000000000000012
21000000000000000000000000000012
21000000000000000000000000000012
21000000000000000000000000000012
21000000000000000000000000000012
21000000000000000000000000000012
21000000000000000000000000000012
21000000000000000000010000000012
21000000000000000000010000000012
21000000000000000000010000000012
21000000000000000000010000000012
21000000000000000000010000000012
21000000000000000000010000000012
21000000000000000000010000000012
21000000000000000000010000000012
21000000000000000000010000000012
22111111111111111111111111111122
22222222222222222222222222222222
