30 30
211111111111111111111111111112
100000001000000000000000000001
100000001000000000000000000001
100000001000000000000000000001
100000001000000000000000000001
100000001000000000000000000001
100000001000000000000000000001
100000001000000000000000000001
100000001000000000000000000001
100000001000000000000000000001
100000001000000000000000000001
100000000000000000000000000001
100000000000000000000000000001
100000000000000000000000000001
100000000000000000000000000001
100000000000000000000000000001
100000000000000000000000000001
100000000000000000000000000001
100000000000000000000000000001
100000000000000000001000000001
100000000000000000001000000001
100000000000000000001000000001
100000000000000000001000000001
100000000000000000001000000001
100000000000000000001000000001
100000000000000000001000000001
100000000000000000001000000001
100000000000000000001000000001
100000000000000000001000000001
211111111111111111111111111112
